6 6
1 1 1 1 1 1
1 0 0 0 0 1
1 0 8 0 9 1
1 0 0 0 0 1
1 0 0 0 0 1
1 1 1 1 1 1