8 8
1 1 1 1 1 9 1 1
8 0 0 0 1 0 0 1
1 0 1 1 1 1 0 1
1 0 1 1 0 1 0 1
1 0 1 1 0 1 0 1
1 0 0 1 0 1 0 1
1 0 0 0 0 0 0 1
1 1 1 1 1 1 1 1 